SalesforceServiceCloud_CL 
| project-rename
		RequestSize=request_size_s,
		ExecTime=exec_time_s,
		Action=action_s,
		PlatformType=platform_type_s,
		OsName=os_name_s,
		OsVersion=os_version_s,
		Timestamp=timestamp_s,
		StatusCode=status_code_s,
		EventType=event_type_s,
		ReferrerUri=referrer_uri_s,
		UserAgent=user_agent_s,
		BrowserType=browser_type_s,
		Time=time_s,
		ResponseSize=response_size_s,
		DeviceId=device_id_s,
		DeviceModel=device_model_s,
		SourceIp=source_ip_s,
		ClientIp=client_ip_s,
		Success=success_s,
		Uri=uri_s,
		Url=url_s,
		ClientName=client_name_s,
		UserType=user_type_s,
		UserInitiatedLogout=user_initiated_logout_s,
		UserIdDerived=user_id_derived_s,
		UserId=user_id_s,
		UserEmail=user_email_s,
		User=user_name_s,
		UriIdDerived=uri_id_derived_s,
		UiEventType=ui_event_type_s,
		UiEventTimestamp=ui_event_timestamp_s,
		UiEventSource=ui_event_source_s,
		UiEventSequenceNum=ui_event_sequence_num_s,
		UiEventId=ui_event_id_s,
		TlsProtocol=tls_protocol_s,
		TimestampDerived=timestamp_derived_t,
		TargetUiElement=target_ui_element_s,
		Sort=sort_s,
		SessionType=session_type_s,
		SessionLevel=session_level_s,
		SessionKey=session_key_s,
		SearchQuery=search_query_s,
		SdkVersion=sdk_version_s,
		SdkAppVersion=sdk_app_version_s,
		SdkAppType=sdk_app_type_s,
		RunTime=run_time_s,
		RowsProcessed=rows_processed_s,
		RowCount=row_count_s,
		ResolutionType=resolution_type_s,
		RequestStatus=request_status_s,
		RequestId=request_id_s,
		ReportIdDerived=report_id_derived_s,
		ReportId=report_id_s,
		RenderingType=rendering_type_s,
		RelatedList=related_list_s,
		RecordType=record_type_s,
		RecordId=record_id_s,
		Quiddity=quiddity_s,
		QueryId=query_id_s,
		PrevpageUrl=prevpage_url_s,
		PrevpageEntityType=prevpage_entity_type_s,
		PrevpageEntityId=prevpage_entity_id_s,
		PrevpageContext=prevpage_context_s,
		PrevpageAppName=prevpage_app_name_s,
		PrefixesSearched=prefixes_searched_s,
		ParentUiElement=parent_ui_element_s,
		PageUrl=page_url_s,
		PageStartTime=page_start_time_s,
		PageEntityType=page_entity_type_s,
		PageEntityId=page_entity_id_s,
		PageContext=page_context_s,
		PageAppName=page_app_name_s,
		Origin=origin_s,
		OrganizationId=organization_id_s,
		NumResults=num_results_s,
		NumberSoqlQueries=number_soql_queries_s,
		NumberFields=number_fields_s,
		NumberExceptionFilters=number_exception_filters_s,
		NumberColumns=number_columns_s,
		NumberBuckets=number_buckets_s,
		MethodName=method_name_s,
		Method=method_s,
		MediaType=media_type_s,
		LoginStatus=login_status_s,
		LoginKey=login_key_s,
		HttpMethod=http_method_s,
		GrandparentUiElement=grandparent_ui_element_s,
		EntryPoint=entry_point_s,
		EntityName=entity_name_s,
		Entity=entity_s,
		EffectivePageTime=effective_page_time_s,
		Duration=duration_s,
		DisplayType=display_type_s,
		DeviceSessionId=device_session_id_s,
		DevicePlatform=device_platform_s,
		DbTotalTime=db_total_time_s,
		DbCpuTime=db_cpu_time_s,
		DbBlocks=db_blocks_s,
		CpuTime=cpu_time_s,
		ConnectionType=connection_type_s,
		ComponentName=component_name_s,
		ClientVersion=client_version_s,
		ClientId=client_id_s,
		CipherSuite=cipher_suite_s,
		CalloutTime=callout_time_s,
		BrowserVersion=browser_version_s,
		BrowserName=browser_name_s,
		AverageRowSize=average_row_size_s,
		AppType=app_type_s,
		AppName=app_name_s,
		ApiVersion=api_version_s,
		ApiType=api_type_s
| extend
        ArticleVersionId=column_ifexists('article_version_id_s',''),
		ArticleVersion=column_ifexists('article_version_s',''),
		ArticleStatus=column_ifexists('article_status_s',''),
		ArticleId=column_ifexists('article_id_s',''),
        AnalyticsMode=column_ifexists('analytics_mode_s',''),
        BatchId=column_ifexists('batch_id_s',''),
        ClickedRecordId=column_ifexists('clicked_record_id_s',''),
		ClassName=column_ifexists('class_name_s',''),
        ComponentIdDerived=column_ifexists('component_id_derived_s',''),
		ComponentId=column_ifexists('component_id_s',''),
        ControllerType=column_ifexists('controller_type_s',''),
		Context=column_ifexists('context_s',''),
		ConsoleIdDerived=column_ifexists('console_id_derived_s',''),
		ConsoleId=column_ifexists('console_id_s',''),    
        ClientInfo=column_ifexists('client_info_s',''),
        DstBytes=RequestSize,
		DstUser=column_ifexists('delegated_user_name_s',''),
        DstUserSid=column_ifexists('delegated_user_id_s',''),
		DstUserSidDerived=column_ifexists('delegated_user_id_derived_s',''),
        Data=column_ifexists('data_s',''),
		DashboardType=column_ifexists('dashboard_type_s',''),
		DashboardIdDerived=column_ifexists('dashboard_id_derived_s',''),
		DashboardId=column_ifexists('dashboard_id_s',''),
		DashboardComponentId=column_ifexists('dashboard_component_id_s',''),
		Duration=ExecTime,
		DvcAction=Action,
		DvcOS=PlatformType,
		DvcOSName=OsName,
		DvcOSVersion=OsVersion,
        DeliveryLocation=column_ifexists('delivery_location_s',''),
		DeliveryId=column_ifexists('delivery_id_s',''),
        DocumentIdDerived=column_ifexists('document_id_derived_s',''),
		DocumentId=column_ifexists('document_id_s',''),
        EntityType=column_ifexists('entity_type_s',''),
        EntityId=column_ifexists('entity_id_s',''),
        FileType=column_ifexists('file_type_s',''),
		FilePreviewType=column_ifexists('file_preview_type_s',''),
		ExceptionType=column_ifexists('exception_type_s',''),
		ExceptionMessage=column_ifexists('exception_message_s',''),
		Ept=column_ifexists('ept_s',''),
        EventCount=column_ifexists('number_of_records_s',''),
		EventEndTime=Timestamp,
		EventResult=StatusCode,
		EventType=EventType,
		FileSize=column_ifexists('size_bytes_s',''),
        HttpReferrerOriginal=ReferrerUri,
		HttpUserAgentOriginal=UserAgent,
		HttpUserAgent=BrowserType,
        LogGroupId=column_ifexists('log_group_id_s',''),
		LimitUsagePercent=column_ifexists('limit_usage_percent_s',''),
		LicenseContext=column_ifexists('license_context_s',''),
		LastVersion=column_ifexists('last_version_s',''),
		Language=column_ifexists('language_s',''),
		JobId=column_ifexists('job_id_s',''),
		IsSuccess=column_ifexists('is_success_s',''),
		IsSecure=column_ifexists('is_secure_s',''),
		IsScheduled=column_ifexists('is_scheduled_s',''),
		IsNew=column_ifexists('is_new_s',''),
		IsMobile=column_ifexists('is_mobile_s',''),
		IsLongRunningRequest=column_ifexists('is_long_running_request_s',''),
		IsGuest=column_ifexists('is_guest_s',''),
		IsFirstRequest=column_ifexists('is_first_request_s',''),
		IsError=column_ifexists('is_error_s',''),
		IsApi=column_ifexists('is_api_s',''),
		IsAjaxRequest=column_ifexists('is_ajax_request_s',''),
        ManagedPackageNamespace=column_ifexists('managed_package_namespace_s',''),
        HttpHeaders=column_ifexists('http_headers_s',''),
		NetworkDuration=Time,
        Name=column_ifexists('name_s',''),
        NumberFailures=column_ifexists('number_failures_s',''),
        NumClicks=column_ifexists('num_clicks_s',''),
        OperationType=column_ifexists('operation_type_s',''),
		NumSessions=column_ifexists('num_sessions_s',''),
        PageName=column_ifexists('page_name_s',''),
        Query=column_ifexists('query_s',''),
        RequestType=column_ifexists('request_type_s',''),
        ReportDescription=column_ifexists('report_description_s',''),
		ReopenCount=column_ifexists('reopen_count_s',''),
        RelatedEntityId=column_ifexists('related_entity_id_s',''),
        RecordIdDerived=column_ifexists('record_id_derived_s',''),
        ReadTime=column_ifexists('read_time_s',''),
		Rank=column_ifexists('rank_s',''),
		SrcBytes=ResponseSize,
		SrcDvcId=DeviceId,
		SrcDvcModelName=DeviceModel,
		SrcIpAddr=SourceIp,
		SrcNatIpAddr=ClientIp,
        SessionId=column_ifexists('session_id_s',''),
        SiteId=column_ifexists('site_id_s',''),
		SharingPermission=column_ifexists('sharing_permission_s',''),
		SharingOperation=column_ifexists('sharing_operation_s',''),
		SharedWithEntityId=column_ifexists('shared_with_entity_id_s',''),
		Success=Success,
		UrlOriginal=Url,
		//User=User,
        WaveTimestamp=column_ifexists('wave_timestamp_s',''),
		WaveSessionId=column_ifexists('wave_session_id_g',''),
		ViewStateSize=column_ifexists('view_state_size_s',''),
		VersionIdDerived=column_ifexists('version_id_derived_s',''),
		VersionId=column_ifexists('version_id_s',''),
        TriggerType=column_ifexists('trigger_type_s',''),
		TriggerName=column_ifexists('trigger_name_s',''),
		TriggerId=column_ifexists('trigger_id_s',''),
		TransactionType=column_ifexists('transaction_type_s',''),
		TotalTime=column_ifexists('total_time_s',''),
        TabId=column_ifexists('tab_id_s',''),
		StackTrace=column_ifexists('stack_trace_s','')
